%%%%%%%%%%%%%%%%%%%%%%%%%%%%%%%%%%%%%
%                               %  P%
% %%%%%%%%%%%%%%%%%%%%%%%%%%%%%%%%% %
% %                                 %
% % %%%%%%%%%%%%%%%%%%%%%%%%%%%%%%%%%
% %                                 %
% %%%%%%%%%%%%%%%%%%%%%%%%%%%%%%%%% %
% %                                 %
% % %%%%%%%%%%%%%%%%%%%%%%%%%%%%%%%%%
% %                                 %
% %%%%%%%%%%%%%%%%%%%%%%%%%%%%%%%%% %
% %                                 %
% % %%%%%%%%%%%%%%%%%%%%%%%%%%%%%%%%%
% %                                 %
% %%%%%%%%%%%%%%%%%%%%%%%%%%%%%%%%% %
% %                                 %
% % %%%%%%%%%%%%%%%%%%%%%%%%%%%%%%%%%
% %                                 %
% %%%%%%%%%%%%%%%%%%%%%%%%%%%%%%%%% %
% %                                 %
% % %%%%%%%%%%%%%%%%%%%%%%%%%%%%%%%%%
% %                                 %
% %%%%%%%%%%%%%%%%%%%%%%%%%%%%%%%%% %
% %                                 %
% % %%%%%%%%%%%%%%%%%%%%%%%%%%%%%%%%%
% %                                 %
% %%%%%%%%%%%%%%%%%%%%%%%%%%%%%%%%% %
% %                                 %
% % %%%%%%%%%%%%%%%%%%%%%%%%%%%%%%%%%
% %                                 %
% %%%%%%%%%%%%%%%%%%%%%%%%%%%%%%%%% %
% %                                 %
% % %%%%%%%%%%%%%%%%%%%%%%%%%%%%%%%%%
% %                                 %
% %%%%%%%%%%%%%%%%%%%%%%%%%%%%%%%%% %
%.                                  %
%%%%%%%%%%%%%%%%%%%%%%%%%%%%%%%%%%%%%
