%%%%%%%%%%%%%%%%%%%%%%%%%%%%%%%%%%%%%
%                                  P%
%%%%%%%%%%%%%%%%%%%%%%%%%%%%%%% % %%%
%                               % % %
%%%%%%%%%%%%%%%%%%%%%%%%%%% % % % %%%
%                           % % % % %
%%%%%%%%%%%%%%%%%%%%%%%%% % % % % %%%
%                         % % % % % %
%%%%%%%%%%%%%%%%%%%%%%%%% % % % % %%%
%                         % % % % % %
%%%%%%%%%%%%%%%%%%%%%%%%% % % % % %%%
%                         % % % % % %
%%%%%%%%%%%%%%%%%%%%%%%%% % % % % %%%
%                         % % % % % %
%%%%%%%%%%%%%%%%%%%%%%% % % % % % %%%
%                       % % % % % % %
%%%%%%%%%%%%%%%%%%% % % % % % % % %%%
%                   % % % % % % % % %
%%%%%%%%%%%%%%%%% % % % % % % % % %%%
%                 % % % % % % % % % %
%%%%%%%%%%%%% % % % % % % % % % % %%%
%             % % % % % % % % % % % %
%%%%%%%%%%%%% % % % % % % % % % % %%%
%             % % % % % % % % % % % %
%%%%%%%%%%%%% % % % % % % % % % % %%%
%             % % % % % % % % % % % %
%%%%%%%%%%% % % % % % % % % % % % %%%
%           % % % % % % % % % % % % %
%%%%%%%%%%% % % % % % % % % % % % %%%
%           % % % % % % % % % % % % %
%%%%%%%%%%% % % % % % % % % % % % %%%
%           % % % % % % % % % % % % %
%%%%%%%%%%% % % % % % % % % % % % %%%
%           % % % % % % % % % % % % %
%%%%%%%%% % % % % % % % % % % % % %%%
%.        % % % % % % % % % % % % % %
%%%%%%%%%%%%%%%%%%%%%%%%%%%%%%%%%%%%%
