%%%%%%%%%%%%%%%%%%%%%%%%%%%%%%%%%%%%%
%               %       %          P%
% % % % % % % %%% % % % % % % % % % %
% %     %   %         %             %
%%%%% % %%% % % % % %%% % % % % % % %
% % %           %     % %     % %   %
% % % %%% % % %%%%%%% % % % % % % % %
%         %     %                   %
% % %%% %%% % % % %%% %%% % % % % % %
%     % %             %   %         %
% % % % % % % %%% %%% % % % % % %%% %
%                         %         %
% % % % % % % %%% %%% % % %%% %%% % %
%               % %           % %   %
% % %%% % % %%% % % % % % % % % % % %
%                     % %     % %   %
% % % % % % % %%%%% %%% % % % % %%%%%
%       %         % %   %     %     %
% % % % %%% % % % % % % %%% % % % % %
% % %         %       %       %     %
% % % % % %%% % % % %%% %%% %%% % % %
%       %       %       %     % %   %
% %%% % % % % % % % % % % %%% % % % %
%         %   %         % % %       %
%%%%% % % % % % % % % %%% % % %%% %%%
% %                     %           %
% % % % % %%% % % % % %%% %%% %%% % %
%         %         %       % %     %
% % % % % % %%% % % % % % % % % % % %
%   %   %     %           % %       %
% %%% %%% % % %%% % % % %%% %%% % % %
%             %     % %         % % %
% %%% % %%%%%%% % %%%%%%% % %%% % %%%
%         %                     %   %
% %%% % % % % % %%% %%% % % %%% % % %
%.      %       %           %       %
%%%%%%%%%%%%%%%%%%%%%%%%%%%%%%%%%%%%%
