%%%%%%%%%%%%%%%%%%%%%%%%%%%%%%%%%%%%%
%       %                         % %
% %%% % % %%%%%%%%%%%%%%% %%%%%%% % %
% %   % %   %     %     % %     %   %
% % %%% %%% % %%% % %%% % % %%% %%% %
% %   %   % %   %   % %   %   %   % %
% %%% %%% %%%%% %%% % %%% %%% %%% %%%
% % %   %     %   % % %   %   % %   %
% % %%% %%%%% %%% % % %%%%% %%% %%% %
%   % %   %       % %       %     % %
%%% % %%% %%%%%%%%%%%%%%%%%%% %%%%% %
% %     %       %           %   %   %
% %%%%% %%%%%%% % %%%%%%% % %%% % %%%
%       %     % % %   %   % %   % % %
% %%%%%%% %%% % % %%% % %%% % %%% % %
%     %   % % % % %   %   % % %   % %
%%%%% % %%% % % % % %%%%% % % % %%% %
% %   % % %     % % %     %   %     %
% % %%% % % %%%%% % % %%%%%%%%%%%%% %
% % %   %   %   % % % %           % %
% % % %%%%%%% % % % % % %%%%% %%% % %
%   %   %   % % %   % % %   %   % % %
% %%%%% % % % % %%% % % % % %%% %%% %
% %   % % %   %   % %   % %   %   % %
% % % % % %%%%%%% % %%%%%%%%% %%% % %
% % % % %   %     % %       %   % % %
% % % % % %%% % %%% % %%%%% %%% % % %
% % % %   %   % %   %   %   %   %   %
%%% % %%%%% % %%% %%% % %%% % % %%%%%
%   %   %   % %   %   %   %   % %   %
% %%%%% % %%%%% %%%%%%%%% %%%%% % % %
%   %.    %   %         % %   % % % %
% % %%%%%%% % %%%%%%%%% % % %%% % %%%
% % %       %   %     %   %   % %   %
% % % %%%%%%% %%% %%% %%%%% % % %%% %
% %         %       %       %      P%
%%%%%%%%%%%%%%%%%%%%%%%%%%%%%%%%%%%%%