%%%%%%%%%%%%%%%%%%%%%%%%%%%%%%%%%%%%%
%.                              %  .%
% % %%% % % % % % % % % %%% % % %%% %
%             %                     %
% % % % % % % %%%%%%%%% %%%%%%%%% % %
%   % % %             %     %     % %
% %%% %%% %%% % %%% %%%%% %%% %%%%% %
%         %           %   %       % %
% % % %%%%% % %%%%% % % % % %%% % % %
% %         %                   %   %
% % %%% % % % %%%%% % % %%% % %%%%% %
%         % %     %     %         % %
% % % % % % %%% % % % %%% % % % % % %
%   %     %                         %
% % % % % %%%%% % % % % % % % % % % %
% %           % %                   %
% % % % % % %%% % % % % % %%% % % % %
%   % %                 % %     %   %
% % % % % % % % % P % %%% %%%%%%% % %
%                             %   % %
% %%%%%%%%% % %%% %%% %%% % % % % % %
%     %               % % %         %
% % % % % % % % % %%% % % % %%%%% % %
% % %       %                   % % %
% %%% % % % % % % % % % % % % % % % %
%             %     %     % %       %
% %%% % % % %%% % %%% % % % % %%% % %
%   %                     % %       %
% % %%% % % %%% % % % %%%%% % % % % %
% %       %                     %   %
% %%% % % % % % % % %%%%%%% % %%% % %
% %         %   %             %   % %
% % %%% % % % % %%% % % %%% %%% % % %
%     %                 %   %   %   %
% % %%% % %%% % % % % %%% % % % % % %
%.      %                          .%
%%%%%%%%%%%%%%%%%%%%%%%%%%%%%%%%%%%%%
