%%%%%%%%%%%%%%%%%%%%%%%%%%%%%%%%%%%%%
%           %   %     %            P%
%%%%%%%%% % % % % %%% % % %%%%%%%%% %
%         % % % % % % % % %       % %
% %%%%% %%%%% % % % % % % % %%%%% % %
%   %   %     %   % %   %   %   % % %
% % %%%%% %%%%%%%%% %%%%%%%%%%% % %%%
% %           %             %   %   %
% %%%%%%%%%%% %%% %%%%%%%%% % %%%%% %
%     %   % % %   %       %   %     %
%%% %%% % % % % %%% %%%%% %%%%% %%% %
%   %   % %     %   %   %     %   % %
% %%% %%% %%% %%% %%% % %%%%% %%% % %
% % % %     % %   % % %     %   % % %
% % % %%%%% %%% %%% % %%%%% %%% % % %
%   %   % %   %   %   %     % %   % %
%%%%%%% % %%% %%% %%%%% %%% % %%%%% %
%   %   %   %     %     %   %   %   %
% %%% %%% %%%%%%%%% %%%%% %%% % % %%%
%     %   %   %   %   % % %   % % % %
%%%%%%%%% % % % % % % % % % %%%%% % %
%         % %   % % % %   %     %   %
% %%%%% %%% %%%%% % % % %%%%%%% %%% %
%     % %   %   %   % %           % %
%%% %%% % %%% %%%%%%% %%%%%%% %%%%% %
%   %   % %   %   %   %     % %     %
% %%% %%% % %%% % % %%% %%% %%% %%%%%
%   %   % %     % %   %   %     %   %
%%%%%%% % %%%%%%% %%% %%% %%%%%%%%% %
%       % %         %   % %         %
% %%%%% % % %%%%%%% %%% % % %%%%% % %
%   %   % %   %       % % %   %   % %
% % %%%%% % % % %%%%%%% % %%% % %%% %
% %   %   % % %   %     % %   % % % %
% %%% % %%%%% %%% % %%%%% %%%%% % % %
%.  %         %   %             %   %
%%%%%%%%%%%%%%%%%%%%%%%%%%%%%%%%%%%%%
