%%%%%%%%%%%%%%%%%%%%%%%%%%%%%%%%%%%%%
%             %       %       %    P%
% %%%%% %%%%% %%%%% % % %%% %%% % % %
% %   %   % %   %   % % % %     % % %
% % % %%% % %%% % %%% % % %%%%%%% %%%
% % %     %   %   %   % % %     %   %
% % %%%%%%% % %%%%% %%% % % %%% %%% %
% % %       % %   %   % %   % % %   %
% % %%%%%%% %%% % %%% % %%%%% % % %%%
% % %     % %   %     % %     %   % %
% % % %%% % % %%%%%%%%% % % %%%%%%% %
% % %   % %   %   %     % %         %
% % %%% % % %%% %%% %%%%% %%%%%%%%% %
% % %   % % %   %   %           %   %
% % % %%% % %%% % %%% %%%%%%%%%%% % %
% %   % % %     % %   %           % %
% %%%%% % %%% %%% %%%%% %%%%%%%%%%% %
% %     % %   %   %   % %       %   %
% %%% % % %%% % %%% % % %%%%%%% % %%%
% %   % %   % % %   %   %       % % %
% % %%% %%% % % %%% %%%%% %%%%%%% % %
%   % % %   % %     %     %     % % %
%%%%% % % %%%%%%%%%%% %%% % %%% % % %
%       %               %     %     %
%%%%%%%%%%%%%%%%%%%%%%%%%%%%%%%%%%%%%
