%%%%%%%%%%%%%%%%%%%%%%%%%%%%%%%%%%%%%
%                 %                P%
% % % %%%%%%% % % % %%% % % % %%% % %
%     %                             %
%%% % % % % % % % % % % %%% % %%%%% %
%       %                     %     %
% % % %%% %%%%%%% % % % % % % % %%% %
%         %     % %   %   % %     % %
%%% %%% %%% % % %%% %%%%% %%%%% % %%%
%                 %     %   %   % % %
% % % % %%% % % % %%% % % % % % % % %
% %     %     %     %             % %
% % % %%% % % % % % %%% % % % %%% % %
%   % %   %               %   %     %
% %%% % % %%% % % % % % % %%% % % % %
%     %                           % %
% % % % % %%% % % % % %%% % %%%%% % %
%                                   %
% % %%% %%% %%% % % % % %%% %%% % % %
%     %           %         %       %
% % % %%%%% % %%% % % % % % % % % % %
%         % % %       %           % %
% % % % % %%% %%% % % % % % % % % % %
%   % %       %   %       % %       %
% % % % % % %%% % %%% %%% % % %%% % %
%           %         %     %       %
% % % % %%% % % % %%% % % %%%%% % % %
%       % %     %       %         % %
% % % %%% % %%%%%%%%% %%%%% %%% % % %
%                         %   %     %
% % % %%% % %%%%%%% % % % % % % % % %
%     %             % %     %       %
% % %%% % % % %%% % %%%%% % % %%% % %
%     %   %     % %           %     %
%%% %%% % % % %%% % % %%% % % % % % %
%.    %                         %   %
%%%%%%%%%%%%%%%%%%%%%%%%%%%%%%%%%%%%%
