%%%%%%%%%%%%%%%%%%%%%%%%%%%%%%%%%%%%%
%.    %             %              .%
% % % % % % %%%%% %%% % % % % % %%% %
%       %     %   %   %   %         %
% % % %%% % % % % %%% %%%%%%% % %%% %
%         %     % %   %   % %       %
% % % % % %%% % % % % % % % % % % % %
%                     % %       % % %
% %%% % % %%% %%% % % % % % % % % % %
% %             %   %               %
% % % % % % % %%%%% %%% % % % % % %%%
%         %           %   % % %     %
% % % % % %%% % % % % % % %%% % % % %
%     % %         % %             % %
%%% % % % % % %%% % % % % % % % %%% %
%               % %   %     %       %
% % % % % % % % %%%%% % %%% % % %%% %
% %         %                       %
%%% % % % % %%% % P % % % % % % % % %
%   %           %             % % % %
% % %%%%% % % %%%%% % % % %%%%%%% % %
%       % %           %             %
% % % % % % % % %%% %%% % % % % % %%%
% % %                 % %       %   %
% % %%% % % %%% % % %%% % %%% %%% % %
%     % %     %     %         %     %
% % % % %%% %%% %%% % % % % % %%% % %
%       %         %     %           %
% % % % % % %%% % % %%%%% %%% %%% %%%
%             % %                   %
% % % % %%% % % % %%% % % % % % % % %
%       % % %                       %
% % % %%% % %%% % %%% % % % % %%% % %
%       %             %   %     %   %
% %%% %%% % % % % %%% %%% % % %%% % %
%.                          %      .%
%%%%%%%%%%%%%%%%%%%%%%%%%%%%%%%%%%%%%
