%%%%%%%%%%%%%%%%%%%%%%%%%%%%%%%%%%%%%
%.        % %     %                .%
%%% % % % % %%% % % % % % %%% % % %%%
%                                   %
% % % %%% % % % % % % %%% %%% % %%% %
%   %         % % %                 %
% %%% %%% % % % % % %%% % % % % % % %
% %     % % %         % %     %     %
% %%% % % %%%%% % % % % % % %%% % % %
% %       %       %         %       %
% % % %%% % %%% %%% % % % % %%% % % %
%       %                 %   %     %
% % %%% %%% %%% %%%%%%%%% % % % % % %
%   %   %   %                   %   %
% % % % % % %%% % %%%%% % %%% %%% % %
%                             %     %
% % %%% % % % % %%%%%%% % % %%% %%% %
%   %     %       %                 %
% %%%%% % %%% % %%P %%% % % % % % % %
%   % %                   %         %
% % % % % % % % % % % %%%%% % % % % %
%             %         %   % %     %
% % % % % %%% % % % %%% % % % % % % %
% % %                     %     % % %
% %%% % % % %%% %%% % % % % % %%%%% %
% % % % %         %       % % %     %
% % % % % % % %%% % % % % % %%% % % %
%         % % %   %                 %
% % % % % % % % % %%% %%% % %%% %%% %
% %         %     % % % % %       % %
% % % % % % %%% % % % % %%% % %%% % %
% %     %               %     %     %
%%% % % %%% % % % %%% % % % % % % % %
%           % %                   % %
% % % % %%%%% % % % %%%%% % % % % % %
%.                  %              .%
%%%%%%%%%%%%%%%%%%%%%%%%%%%%%%%%%%%%%
