%%%%%%%%%%%%%%%%%%%%%%%%%%%%%%%%%%%%%
%                       %          P%
% %%%%% % % % %%%%% % % % % % % % % %
%   % %             % %     %       %
% %%% %%% %%% % % % % % % %%% % % % %
% %       %         % % % %     % % %
% % % % % %%%%% % % % % %%% % % %%% %
%     %     %         % %           %
% %%% %%% % % % % % %%% % % %%% %%% %
% %     %     %                 %   %
% % % % % % %%% %%%%% % % %%% % % % %
%         %     %           % %   % %
% % %%% % % % % % %%% %%% % % % % %%%
%                         %         %
% % %%% % %%% % % %%% % % % % % %%% %
%         %   % %             %     %
%%% %%% % %%% %%%%% % % % %%% % %%% %
%     %         %                   %
% % % %%% %%% %%% % % %%% % % % % % %
%         %             %           %
% % % % % %%% % % % % % %%%%% % % % %
%     % %       % %     %           %
% % % % % % %%% % %%% % % % % % % % %
%   %     %   % %               %   %
% % % % % % %%% %%%%% % % % % %%%%% %
%     %                         %   %
% % % %%%%% % % % % % %%% %%% %%% % %
%                       %       %   %
% %%% % % % % % % % % % % %%% %%% % %
%               % %         %       %
% % % % % % % % %%% %%% % % % % % % %
%     % %                         % %
% % %%% % % %%% %%% %%% % % %%% % % %
%     %   %     %       %   %       %
% % % % % % % % % % % % % % % %%% % %
%.    %         %   %               %
%%%%%%%%%%%%%%%%%%%%%%%%%%%%%%%%%%%%%
