%%%%%%%%%%%%%%%%%%%%%%%%%%%%%%%%%%%%%
%.                        %   %    .%
% % % % % %%% % % % % %%% % % % % % %
% %       %               %     %   %
% % % % % % % % % % % % % % % % % % %
% % %             % %     %   %     %
%%% % %%%%% % % %%% %%% %%% %%% % % %
%     %         % %     %   %       %
%%% % % %%% %%% % % %%% % %%% % % %%%
%       %   %   %     %             %
% %%% %%% %%% % % % % % % %%% % % % %
%                   %           % % %
% % % % %%% % % % % % %%% % %%%%% %%%
%     % %       %       % %         %
% %%% % % % %%% %%% % % %%% % % % %%%
%     % % %   % %       %       % % %
% %%%%% % %%% %%% % % % % % %%% % % %
% %       % % % % %                 %
% %%% % % % % % % P % %%% % %%% % % %
%                     %   % %       %
% % % % % % %%% % %%% % % % % % % %%%
%                 %         %       %
%%% %%% % %%% %%% % % % % % %%%%% %%%
%         %   % %   %           %   %
% %%%%% %%% %%% % % %%% % % % % % % %
%         % %         % %           %
% %%% % % %%% % % %%% %%% %%% %%% %%%
%       %         %             %   %
% % % % %%% % %%%%%%% % % %%% % %%% %
%                                 % %
% % %%% %%% %%%%% % % % % %%% %%% % %
%                           %       %
% % % % %%% %%% %%% % %%% % %%%%%%% %
% % %               %               %
% % % % %%% % % %%%%% %%%%% % %%% % %
%.%       %             %       %  .%
%%%%%%%%%%%%%%%%%%%%%%%%%%%%%%%%%%%%%
