%%%%%%%%%%%%%%%%%%%%%%%%%%%%%%%%%%%%%
%         %         %     %        P%
%%%%% % %%% % %%%%% %%%%% % %%%%%%% %
%   % %     % %   %       %   % %   %
% % %%% %%%%% % % %%%%%%% %%% % % %%%
% %   %     % % %           % % % % %
% %%% %%%%% % %%%%%%%%%%%%% % % % % %
%   %     % %     %     %   % % % % %
%%% %%%%% %%%%% % % %%% %%% % % % % %
%   % %   %   % %     %   % % % %   %
% %%% % %%% % %%%%%%%%%%% % % % %%% %
% %   % %   % %         % % % %   % %
% %%% % %%% % % %%%%%%% % % % %%% % %
%   %   %   % %   %   % % % %   % % %
% % %%% % %%% % % % %%% % % %%% % % %
% %   %   %   % % % %   % %   % %   %
% %%% %%%%% %%% % % % %%% %%%%% % %%%
% %   %   %   % % %   %   %     %   %
% % %%%%% %%% % % % %%%%% % % %%%%% %
% % %       % % % %       % % %   % %
% % % % %%% % %%% %%%%%%% % % %%% % %
% % % %   % %   %   %   % % % %   % %
% % %%% % %%%%% %%% % % %%% %%% %%% %
% %   % %           % %   %   %   % %
%%%%% % %%%%%%%%%%%%% %%% %%% %%% % %
%   % % %   %         % %   %   % % %
% % % % %%% % %%%%%%%%% %%% % %%% % %
% %   %     %   %       %   %     % %
% % %%%%%%% %%% %%%%% %%% %%%%%%%%% %
% % %   %   % %     %   % %     %   %
% %%% % % %%% %%%%% % % % % % %%% %%%
%     % %       %   % % %   % %   % %
%%%%%%% %%%%%%%%% %%%%% %%%%% % %%% %
%       %   %   % %   %     % % %   %
% %%%%%%% % % % % % % %%% % % % % % %
%.        %   %     %     % %     % %
%%%%%%%%%%%%%%%%%%%%%%%%%%%%%%%%%%%%%
